#######################################
# Syntax Coloring Map for the SparkFun sm√¥l Power Board Arduino Library
#######################################

#######################################
# Datatypes (KEYWORD1)
#######################################

smolPowerAAA	KEYWORD1
smolPowerLiPo	KEYWORD1

#######################################
# Methods and Functions (KEYWORD2)
#######################################

begin	KEYWORD2
isConnected	KEYWORD2
setI2CAddress	KEYWORD2
getI2CAddress	KEYWORD2
getResetReason	KEYWORD2
getTemperature	KEYWORD2
getBatteryVoltage	KEYWORD2
measureVCC	KEYWORD2
setADCVoltageReference	KEYWORD2
getADCVoltageReference	KEYWORD2
setWatchdogTimerPrescaler	KEYWORD2
getWatchdogTimerPrescaler	KEYWORD2
setPowerdownDurationWDTInts	KEYWORD2
getPowerDownDurationWDTInts	KEYWORD2
powerDownNow	KEYWORD2

#######################################
# Constants (LITERAL1)
#######################################

SFE_SMOL_POWER_DEFAULT_I2C_ADDRESS	LITERAL1
SFE_SMOL_POWER_RESET_REASON_PORF_BIT	LITERAL1
SFE_SMOL_POWER_RESET_REASON_PORF	LITERAL1
SFE_SMOL_POWER_RESET_REASON_EXTRF_BIT	LITERAL1
SFE_SMOL_POWER_RESET_REASON_EXTRF	LITERAL1
SFE_SMOL_POWER_RESET_REASON_BORF_BIT	LITERAL1
SFE_SMOL_POWER_RESET_REASON_BORF	LITERAL1
SFE_SMOL_POWER_RESET_REASON_WDRF_BIT	LITERAL1
SFE_SMOL_POWER_RESET_REASON_WDRF	LITERAL1
SFE_SMOL_POWER_EEPROM_CORRUPT_ON_RESET_BIT	LITERAL1
SFE_SMOL_POWER_EEPROM_CORRUPT_ON_RESET	LITERAL1
SFE_SMOL_POWER_COMM_ERROR_BIT	LITERAL1
SFE_SMOL_POWER_COMM_ERROR	LITERAL1
SFE_SMOL_POWER_REGISTER_I2C_ADDRESS	LITERAL1
SFE_SMOL_POWER_REGISTER_RESET_REASON	LITERAL1
SFE_SMOL_POWER_REGISTER_TEMPERATURE	LITERAL1
SFE_SMOL_POWER_REGISTER_VBAT	LITERAL1
SFE_SMOL_POWER_REGISTER_1V1	LITERAL1
SFE_SMOL_POWER_REGISTER_ADC_REFERENCE	LITERAL1
SFE_SMOL_POWER_REGISTER_WDT_PRESCALER	LITERAL1
SFE_SMOL_POWER_REGISTER_POWERDOWN_DURATION	LITERAL1
SFE_SMOL_POWER_REGISTER_POWERDOWN_NOW	LITERAL1
SFE_SMOL_POWER_REGISTER_FIRMWARE_VERSION	LITERAL1
SFE_SMOL_POWER_USE_ADC_REF_VCC	LITERAL1
SFE_SMOL_POWER_USE_ADC_REF_1V1	LITERAL1
SFE_SMOL_POWER_USE_ADC_REF_UNDEFINED	LITERAL1
SFE_SMOL_POWER_WDT_TIMEOUT_16ms	LITERAL1
SFE_SMOL_POWER_WDT_TIMEOUT_32ms	LITERAL1
SFE_SMOL_POWER_WDT_TIMEOUT_64ms	LITERAL1
SFE_SMOL_POWER_WDT_TIMEOUT_125ms	LITERAL1
SFE_SMOL_POWER_WDT_TIMEOUT_250ms	LITERAL1
SFE_SMOL_POWER_WDT_TIMEOUT_500ms	LITERAL1
SFE_SMOL_POWER_WDT_TIMEOUT_1s	LITERAL1
SFE_SMOL_POWER_WDT_TIMEOUT_2s	LITERAL1
SFE_SMOL_POWER_WDT_TIMEOUT_4s	LITERAL1
SFE_SMOL_POWER_WDT_TIMEOUT_8s	LITERAL1
SFE_SMOL_POWER_WDT_TIMEOUT_UNDEFINED	LITERAL1
